#########
#x#######
#xxx  ###
# # # ###
#   cc s#
###  cc #
#####   #
#########
