#######
###  ##
#   c #
# #x#s#
# #c x#
#  xc #
##   ##
#######
