######
#   x#
# cc #
# s###
##x###
######
